metre	metres
meter	meters
thou
inch	inches
foot	feet
yard	yards
chain	chains
furlong	furlongs
mile	miles
league	leagues
fathom	fathoms
gram	grams
ton	tons
tonne	tonnes
grain	grains
dram	drams
drachm	drachms
ounce	ounces
pound	pounds
stone	stones
quarter	quarters
hundredweight	hundredweights
ampere	amperes
second	seconds
minute	minutes
hour	hours
day	days
week	weeks
month	months
year	years
fortnight	fortnights
kelvin	kelvins
celsius
celcius
fahrenheit	fahrenheit
candela	candelas
mole	moles
molarity
weight	weights
weight percent	weight percents
part per million	parts per million
part per billion	parts per billion
cubic meter	cubic meters
cubic metre	cubic metrs
litre	litres
liter	liters
fluid ounce	fluid ounce
ounce	ounces
gill	gills
cup	cups
pint	pints
quart	quarts
gallon	gallons
cubic inch	cubic inches
volt	volts
farad	farads
ohm	ohms
siemens
joule	joules
coulomb	coulombs
henri	henries
henry	henries
watt	watts
tesla	teslas
weber	webers
decibel	decibels
volt per metre	volts per metre
volt per meter	volts per meter
ampere per metre	amperes per metre
ampere per meter	amperes per meter
round per minute	rounds per minute
round per second	rounds per second
hertz
wavenumber	wavenumbers
reciprocal centimeter	reciprocal centimeters
meter per second	meters per second
metre per second	metres per second
mile per hour	miles per hour
knot	knots
nautical mile per hour	nautical miles per hour
inch per second	inches per second
mach
speed of sound
