m	LENGTH	SI_BASE	metre,meter
th	LENGTH	IMPERIAL	thou
in	LENGTH	IMPERIAL	inch
ft	LENGTH	IMPERIAL	foot
yd	LENGTH	IMPERIAL	yard
ch	LENGTH	IMPERIAL	chain
fur	LENGTH	IMPERIAL	furlong
mi	LENGTH	IMPERIAL	mile
lea	LENGTH	IMPERIAL	league
ftm	LENGTH	IMPERIAL	fathom
g	MASS	SI_BASE	gram
t	MASS	NON_SI	ton,tonne
gr	MASS	IMPERIAL	grain
drc	MASS	IMPERIAL	dram,drachm
oz	MASS	IMPERIAL	ounce
lb	MASS	IMPERIAL	pound
st	MASS	IMPERIAL	stone
qtr	MASS	IMPERIAL	quarter
cwt	MASS	IMPERIAL	hundredweight
A	ELECTRIC_CURRENT	SI_BASE	ampere
s	TIME	SI_BASE	second
min	TIME	NON_SI	minute
h	TIME	NON_SI	hour
	TIME	NON_SI	day
	TIME	NON_SI	week
	TIME	NON_SI	month
	TIME	NON_SI	year
	TIME	NON_SI	fortnight
K	TEMPERATURE	SI_BASE	kelvin
°C	TEMPERATURE	SI_DERIVED	celsius,celcius
°F	TEMPERATURE	US	fahrenheit
cd	LUMINOUS_INTENSITY	SI_BASE	candela
mol	AMOUNT_OF_SUBSTANCE	SI_BASE	mole
M	CONCENTRATION	NON_SI	molarity
mol/L	CONCENTRATION	NON_SI	molarity
mol/m^3,mol/m³	CONCENTRATION	SI_BASE	molarity
w/w%	CONCENTRATION	NON_SI	weight/weight percent
ppm	CONCENTRATION	NON_SI	part per million
ppb	CONCENTRATION	NON_SI	part per billion
m^3,m³	VOLUME	SI_BASE	cubic meter,cubic metre
l	VOLUME	NON_SI	litre,liter
oz,fl oz,fl. oz.,oz. fl.	VOLUME	US,IMPERIAL	fluid ounce
gi	VOLUME	US	gill
c	VOLUME	US	cup
pt	VOLUME	US	pint
qt	VOLUME	US	quart
gal	VOLUME	US	gallon
cu in	VOLUME	US	cubic inch
V	VOLTAGE	SI_DERIVED	volt
F	ELECTRIC_CAPACITANCE	SI_DERIVED	farad
Ω	ELECTRIC_RESISTANCE	SI_DERIVED	ohm
S	ELECTRIC_CONDUCTANCE	SI_DERIVED	siemens
J	ENERGY	SI_DERIVED	joule
C	ELECTRIC_CHARGE	SI_DERIVED	coulomb
H	INDUCTANCE	SI_DERIVED	henri,henry
W	POWER	SI_DERIVED	watt
T	MAGNETIC_INDUCTION	SI_DERIVED	tesla
Wb	MAGNETIC_FLUX	SI_DERIVED	weber
dB	ATTENUATION	SI_DERIVED	decibel
V/m	ELECTRIC_FIELD	SI_DERIVED	volt per metre,volt per meter
A/m	MAGNETIC_FIELD_STRENGTH	SI_DERIVED	ampere per metre,ampere per meter
rpm,round/min	FREQUENCY	NON_SI	round per minute
rps,round/s	FREQUENCY	NON_SI	round per second
Hz	FREQUENCY	SI_BASE	hertz
cm^-1,cm⁻¹	ENERGY	SI_DERIVED	wavenumber,reciprocal centimeter
m/s	VELOCITY	SI_DERIVED	meter per second,metre per second
mi/h,mph	VELOCITY	US	mile per hour
knot	VELOCITY	US	knot,nautical mile per hour
ips	VELOCITY	US	inch per second
Mach	VELOCITY	NON_SI	mach,speed of sound
atm	PRESSURE	NON_SI	atmosphere
Pa	PRESSURE	SI_DERIVED	pascal
Bar	PRESSURE	NON_SI	bar
at	PRESSURE	NON_SI	technical atmosphere
Torr	PRESSURE	NON_SI	torr
psi	PRESSURE	US	pound per square inch, pound-force per square inch
Pl  VISCOSITY   SI_DERIVED  poiseuille, pascal per second
P   VISCOSITY   NON_SI  poise
